NO       ./textures/north.xpm 
SO      ./textures/south.xpm





WE                      ./textures/west.xpm
EA ./textures/east.xpm

F 0,100,0
C 0,0,40


111111111111111111111111111111111111111111111111111111111
100011111000000000000000000000000000000000000000000000001
111011110000000000000000000000000000000000000000000000001
100011100000010000000000000000000000000000000000000000001
101111000000000000000000000000M00000000000000000000000001
10000000001000000S00000000000000000000M000000000000000001
111110000000000000000000000000000000000000000000000000001
10000100000000000000000000000000000000M00000000000000001
100000100000000001000000000000M00000000000000000000000001
100000010000000000000000000000000000000000000000000000001
100000000000000000000000000000000000000000000000000000001
111111111111111111111111111111111111111111111111111111111