NO       ./textures/north.xpm 
SO      ./textures/south.xpm





WE                      ./textures/west.xpm
EA ./textures/east.xpm

F 0,100,0
C 0,0,40


11111111111111111111111111111
10001111100000000000001000001
11101111000011111111111111001
10001110000001000000001000001
10111100000000000000001000001
10000000001000000S00001000M01
11111000000000000000001000001
10000100000000000000001000001
10000010000000000100001000001
10000001000000000000MMMMM0001
10000000000000000000000000001
11111111111111111111111111111
