NO       ./textures/north.xpm 
SO      ./textures/south.xpm





WE                      ./textures/west.xpm
EA ./textures/east.xpm

F 139,69,19
C 0,0,0

1111111111111
1000000S00001
1011110111101
1010000000M01
101111D111101
1000000000001
1111111111111
