NO       ./textures/north.xpm 
SO      ./textures/so.xpm





WE                                      ./textures/we.xpm
EA ./textures/ea.xpm

F 255,255,255
C 002,100,233

   1111111111111111111
   1000000000100000001
   1011000000100000001 
   1000010000000000001 
1111111110000111111111       
10000S0000110000000001
111111110100111111011111
    10000000001100000001
    10110000001000000001 
    10000100000000001001 
    11111111111111111111 