NO       ./textures/north.xpm 
SO      ./textures/south.xpm
WE                      ./textures/west.xpm
EA ./textures/east.xpm
F 139,69,2
C 0,0,0

                  111111111111111111111
                  10M00M0000001000M1111
                  11111101111M111101111
                  10100S000000D0M011111
                  111D1D11D1010D1011111
                  1000M0M000M01000011 1
                  111111111111111111111
