NO       ./textures/north.xpm 
SO      ./textures/south.xpm





WE                      ./textures/west.xpm
EA ./textures/east.xpm

F 139,69,19
C 0,0,0

   1111111
   1000001
   1011001 
   1011001 
   1011001 
   1011001 
   1011001 
   1011001 
   1011001 
   1011001 
   101D001 
   1011001 
   1011001 
   1011001 
   1011001 
   10111D1 
   1011001 
   1011001 
   1011001 
   1011001 
   1011001 
   1011001 
   10000001 
111111111D111111111111       
10S000000000000000001
111111010000D11111011111
    10000000001100000001
    10010111D110D0000001 
    10000100000D00001001 
    11D11100D00000001001 
    10000100000000001001 
    10000100000000001001 
    11111111111111111111 
