NO ./textures/future_wall.xpm
SO 			./textures/future_wall.xpm
WE ./textures/horror.xpm
EA ./textures/horror.xpm
F 184 , 69,2
C 255,255,255

                              


111111111111111
111111011110111
101000001000001
1010000010000W1   1111
101000001000001
101000001000001
101000001000001
101000001000001
101000001000001
101000001000001
101000001000001
101000001000001
101000001000001
101000001000001
101000001000001
101000001000001
101000001000001
101000001000001
101000001000001
101000001000001
101000001000001
101000001000001
101000001000001
101000001000001
101000001000001
101000001000001
101000001000001
101000001000001
101000001000001
111111111111111
