NO       ./textures/north.xpm 
SO      ./textures/south.xpm





WE                      ./textures/west.xpm
EA ./textures/east.xpm

F 0,100,0
C 0,0,40

   1111111111111111111
   1000000000100000001
   1011000000100000001 
   1000010000000000001 
1111111110000111111111       
10S000000010000000001
111111110100111111011111
    10000000001100000001
    10110000001000000001 
    10000100000000001001 
    11111111111111111111 