NO       ./textures/north.xpm 
SO      ./textures/so.xpm





WE                                      ./textures/we.xpm
EA ./textures/ea.xpm

F 002,100,33
C 002,100,233


                        11111111111111111111111 
                        10000000001000000000001
                        10110000001000000000001 
                        10000100000000000001001 
11111111111111111111111110000000001111111111111       
10000000000000100000000000100000001
11111111111111111111111111111111111  111111
 
11111111111111111111111111111111111
1000000010100000000001111  11111111                
1000000000000100001001011
1000101010100000000001111
1100000000000N00000000001111
11111111111111111110101011
1000111 111101 10100111111
1111111 111111 11111111111

                                                     
