NO       ./textures/north.xpm 
SO      ./textures/south.xpm





WE                      ./textures/west.xpm
EA ./textures/east.xpm

F 139,69,19
C 0,0,0

111111111111111111
100M000S000M1000M1
101111011110111101
101000000000D00001
1011D1D11D1010D101
100000000000100001
111111111111111111
