NO       ./textures/north.xpm 
SO      ./textures/south.xpm





WE                      ./textures/west.xpm
EA ./textures/east.xpm

F 139,69,19
C 135,206,235

   1111111
   1000001
   1011001 
   1011001 
   1011001 
   1011001 
   1011001 
   1011001 
   1011001 
   1011001 
   1011001 
   1011001 
   1011001 
   1011001 
   1011001 
   1011001 
   1011001 
   1011001 
   1011001 
   1011001 
   1011001 
   1011001 
   10000001 
1111111110111111111111       
10S000000D10000000001
111111110100111111011111
    10000000001100000001
    10110111D110D0000001 
    10000100000000001001 
    11111111111111111111 
