NO       ./textures/north.xpm 
SO      ./textures/south.xpm





WE                      ./textures/west.xpm
EA ./textures/east.xpm

F 139,69,19
C 0,0,0

   1111111111111111111111111111111111111111111111111111111111
   10000000000M0000000000000000000000000000000000000000000001
   1011000000000000000000000000000000000000000000000000000001 
   1011000M000000000M0000M00000000000000000000000000000000001 
   1011000000000000000000000000000000000000000000000000000001 
   10111D1111111D11111100000000000000000000000000000000000001 
   1011M00000000000000000000000000000000000000000000000000001 
   1011000000000000000000000000000000000000000000000000000001 
   1011000000000000000000000000000000000000000000000000000001 
   101100000000000000000M000000000000000000000000000000000001 
   1010000000000000000000000000000000000000000000000000000001 
   1011000000000000000000000000000000000000000000000000000001 
   101100000000000000000000000000000000M000000000000000000001 
   1011000000000000000000000000000000000000000000000000000001 
   1011000000000000000000000000000000000000000000000000000001 
   10111D0S0000000000000M000000000000000M00000000000000000001 
   1011000000000000000000000000000000000000000000000000000001 
   1011000000000000000000000000000000000000000000000000000001 
   101100000000000000000000000000000M000000000000000000000001 
   1011000000000000000000000000000000000000000000000000000001 
   1011000000000000000000000000000000000000000000000000000001 
   1011000000000000000000000000000000000000000000000000000001 
   11111111111111111111111111111111111111111111111111111111111 
