NO       ./textures/north.xpm 
SO      ./textures/so.xpm



C                                                                                   29,3,000003


WE                                      ./textures/we.xpm
EA ./textures/ea.xpm

F 002,100,233

            11111111111111111111111              
            10000000001000000000001
            10110000001000000000001
            10000100000000000001001
11111111111110110100000000000000001
10000000000000100000000000100000001
10000000S00000000000001111111111111
10000000000000000010010101
1000101010100000000001111
11000000000000000000000001111
11111111111111111110101011
10001111111101110100111111
11111111111111 11111111111