NO       ./textures/north.xpm 
SO      ./textures/so.xpm





WE                                      ./textures/we.xpm
EA ./textures/ea.xpm

F 255,255,255
C 002,100,233


        11111111111111111111111 
        10000000001000000000001
        10110000001000000000001 
        10000100000000000001001 
1111111111111110000111111000111111       
100000000S0000100000000000100001
11111111111111100001111111111111111
    10000000001000000000001
    10110000001000000000001 
    10000100000000000001001 
    11111111111111111111111 