NO       ./textures/north.xpm 
SO      ./textures/so.xpm





WE                                      ./textures/we.xpm
EA ./textures/ea.xpm

F 255,255,255
C 002,100,233

1111111111111111111
1000000000100000001
1011000000000000001 
1000010000000000001 
1111111110000111111       
10000S0000110000001
1100111101001100111
1000000000110000001
1011000000100000001 
1000010000000001001 
1111111111111111111 