NO       ./textures/north.xpm 
SO      ./textures/so.xpm

                        
WE ./textures/we.xpm
EA ./textures/ea.xpm

F 002,100,10
C 4,30,10

            11111111111111111111111
            10000000001000000000001
            10110000001000000000001
            10000100000000000001001
11111111111110110100000000000000001
10000000000000100000000000100000001
10000000000000000000001111111111111
10000000000000000010010101
10001010101000000000011111
11000000000000000000000001111
11111111111111111110101011
1000111 111101 10100111111
1111111 111111 11111111111
