NO       ./textures/north.xpm 
SO      ./textures/south.xpm





WE                      ./textures/west.xpm
EA ./textures/east.xpm

F 139,69,19
C 0,0,0

   111111111111111111111111111111
   100000000000000000000000000001
   101100000000000000000000000001 
   101100000000000000000000000001 
   101100000000000000000000000001 
   10111D1111111D1111110000000001 
   101100000000000000010000000001 
   101100000000000000010000000001 
   101100000000000000010000000001 
   101100000000000000010000000001 
   101000000000000000010000000001 
   1011000000000000000D0000000001 
   101100000000000000010000000001 
   101100000000000000010000000001 
   101100000000000000010000000001 
   10111D000000000000010000000001 
   1011000000000000000D0000000001 
   101100000000000000010000000001 
   101100000000000000010000000001 
   101100000000000000010000000001 
   101100000000000000010000000001 
   101100000000000000000000000001 
   1000000000000001111111111111111 
1111111110111D11111111       
100000000000000000001
111111010000011111011111
    10000000001100000001
    10010111011000000001 
    10000100000000001001 
    11011100000S00001001 
    10000D00000000001001 
    10000100000000001001 
    11111111111111111111 
