NO       ./textures/north.xpm 
SO      ./textures/south.xpm





WE                      ./textures/west.xpm
EA ./textures/east.xpm

F 0,100,0
C 0,0,40


11111111111111111111111111111
1000111110M000000000M01000001
11101111000011111111111111001
10001110000001000000001M00001
10111100000000000000001000001
100000M0001000000S00001000M01
111110000000M0000000001000001
100001000M0000000000001000001
10000010000000000100001000001
100000010000M00000000M0000001
1000M0000000000000M0000000001
11111111111111111111111111111
