NO ./textures/future_wall.xpm 
SO 	./textures/future_wall.xpm
WE ./textures/future_wall.xpm
EA ./textures/future_wall.xpm
F 139,69,12
C 0,0,0

111111111111111
11111101111M111
101000001000001
1011D111111D111
101000001000001
101000001001001
1010M0001001001
101000001001001
101000001001001
101011101M01001
101000001001001
101000M01001001
1010M0001001001
10100S001001001
101000001001001
1M1000001001001
1010M0M01001001
101000001001001
101000001001001
101000001001001
101000001001001
10100M0010M1001
101000001001D01
10100M001001D01
101000000001D01
111D1D11D1010D1
1000M0M000M0101
111111111111111
