NO ./textures/floor.xpm
SO ./textures/horror.xpm
WE ./textures/future_wall.xpm
EA ./textures/future_wall.xpm
F 110, 110, 110
C 0, 0,0 

111111111111111111111111
111111011110110000000001
1010000010000S0000000001
1010M1001001000000000001   1111
10100100D001000000000001
101001001001000000000001
1010010010010M0000000001
1M10M1001001000000000001
1010M1001001000000000001
1010M100100100000000M001
1010M1001001M00000000001
101001001001000000000001
101001001001000000000001
1010010010010000000D0001
101001001001000M00000001
101001001001000000000001
11111110D001000000000001
101001001001000000000001
101001001001000000000001
101M01001001000000000001
101001001M010000M0000001
101001001001000000000001
101001001001000000000001
101001001001000000000001
101001D0100100000000M001
101001001001000000000001
10100D010010010000000001
101001001001000000000001
101001001000000000000001
111111111111111111111111
