NO ./textures/future_wall.xpm
SO ./textures/future_wall.xpm
WE ./textures/future_wall.xpm
EA ./textures/future_wall.xpm
F 139,69,12
C  0,0,0

111111111111111111111111111111
10000000000000M0000000000000W1
1000M0000000000000000000M00001
100011111111111111111111110001
10001                    10001
10001                    10001
100011111111111111111111110001
10000000000000M000000000000001
100011111111111111111111110001
10001                    10001
10001                    10001
10001                    10001
100011111111111111111111110001
10000000000000M000000000000001
1000M0000M00000000000000M00001
111111111111111111111111111111
