NO ./textures/future_wall.xpm 
SO 	./textures/future_wall.xpm
WE ./textures/future_wall.xpm
EA ./textures/future_wall.xpm
F 139,69,12
C 0,0,0

1111111111111111111111111111111111111111111111111111111111111111111111111111111
11111101111M1111011111111111111111111111111111111111111111111111111111111111111
1010000010000000000000000000000000000000000000000000000000000000000000000000001
1010000010000000000000000000000000000000000000000000000000000000000000000000001
1010000010000000000000000000000000011111111111111111111111111111111000000000001
10100000100000000000S0000000000000000000000000000000000000000000000000000000001
1010000010000000000000000000000000000000000000000000000000000000000000000000001
10100000100000000000000000000000000M0000000000000000000000000000000000000000001
10100000100000000000000000000000000000000000M0000000000000000000000000000000001
101000001M000000000000000000000000000000000000000000000000000000000000000000001
1010000010000000000000000000000000000000000000000000000000000000000000000000001
1010000010000000011111111111111111111111111111111111111111111111111111111111101
1010000010000000000000000000000000000000000000000000000000000000000000000000001
1010000010000000000000000000000000000000000000000000000000000000000000000000001
1010000010000000000000000000000000000000000000000000000000000000000000000000001
1010000010000000000000000111111111111111111111111111111111111111111111111111111
1010000010000000000000000000000000000000000000000000000000000000000000000000001
1010000010000000000000000100000000000000000000000000000000000000000000000000001
1010000010000000000000000000000000000000000000000000000000000000000000000000001
1010000010000000000000000000000000000000000000000000000000000000000000000000001
1010000010000000000000000000000000000000000000000000000000000000000000000000001
1010000010000000000000000000000000000000000000000000000000000000000000000000001
101000001000D000000000000000000000000000000000000000000000000000000000000000001
101000001000D000000000000000000000000000000000000000000000000000000000000000001
101000000000D000000000000000000000000000000000000000000000000000000000000000001
111D1D11D1010D10000000000000000000000000000000000000000000000000000000000000001
1000M0M000M01000011111111111111111111111111111111111111111111111111111111111111
1111111111111111111111111111111111111111111111111111111111111111111111111111111
