NO ./textures/floor.xpm
SO ./textures/horror.xpm
WE ./textures/future_wall.xpm
EA ./textures/future_wall.xpm
F 19, 69,12
C 255,255,255 

111111111111111
111111011110111
1010000010000S1
1010M1001001001   1111
10100100D001001
101001001001001
1010010010010M1
1010M1001001001
1010M1001001001
1010M10010010M1
1010M10010010M1
1010010010010M1
1010010010010M1
101001001001001
101001001001001
101001001001001
11111110D001001
101001001001001
101001001001001
101001001001001
101001001001001
101001001001001
101001001001001
101001001001001
101001D01001001
101001001001001
10100D01001001
101001001001001
101001001000001
111111111111111
