NO ./textures/wall.xpm
SO ./textures/horror.xpm
WE ./textures/future_wall.xpm
EA ./textures/future_wall.xpm
F ./textures/floor.xpm
C 135, 206, 235
111111111111111
111111011110111
1010000010000S1
1010010010010011111
1010010010010011111
1010010010010011111
1010010010010011111
1010010010010011111
1010010010010011111
1010010010010011111
1010010010010011111
1010010010010011111
1010010010010011111
1010010010010011111
1010010010010011111
1010010010010011111
1010010010010011111
1010010010010011111
1010010010010011111
1010010010010011111
1010010010010011111
1010010010010011111
1010010010010011111
1010010010010011111
1010010010010011111
1010010010010011111
1010010010010011111
1010010010000011111
1111111111111111111 